{
  "maze": [
    "###############",
    "#     TG#   TG#",
    "#T### ### # #G#",
    "# #T#   # # #T#",
    "# #T### # # ###",
    "#   BE#G  #   #",
    "#G########### #",
    "#G#     #   # #",
    "#G# ### # # # #",
    "#T# #GT  G#   #",
    "### #########G#",
    "#   #S      #G#",
    "# ######### #T#",
    "#           #T#",
    "###############"
  ]
}
