{
  "maze": [
    "###############",
    "# G #   #   # #",
    "###G### #G### #",
    "# GG  G       #",
    "# #G# # ##### #",
    "# #G# #   #E# #",
    "### ###T###B# #",
    "# # #GG   #   #",
    "# ### #########",
    "#       G     #",
    "# ##### ###G# #",
    "# T  T# T #G#G#",
    "####### # # # #",
    "# G GGG # #T#S#",
    "###############"
  ]
}
