{
  "maze": [
    "###############",
    "#   #T# # G   #",
    "### # #G###G###",
    "#   #TGG  #TGG#",
    "### ##### # ###",
    "#G      # G G #",
    "### ### #T### #",
    "#     #  G  # #",
    "##### # ### ###",
    "#EB   # #     #",
    "######### #####",
    "# G  T  #   GT#",
    "# #####G# ### #",
    "#S#  TG     # #",
    "###############"
  ]
}