{
  "maze": [
    ["#", "#", "#", "#", "#", "#", "#", "#", "#", "#", "#", "#", "#", "#", "#", "#", "#", "#", "#", "#", "#"],
    ["#", " ", " ", "G", "#", "#", "#", "#", "#", "#", "#", "#", "#", "#", "#", "#", "#", "#", "#", "#", "#"],
    ["#", "#", "#", " ", "#", "#", "#", "#", "#", "#", "#", "#", "#", "#", "#", "#", "#", "#", "#", "#", "#"],
    ["#", " ", " ", " ", " ", " ", "#", "#", "#", "#", "#", "#", "#", "#", "#", "#", "#", "#", "#", "#", "#"],
    ["#", "#", "#", "G", "#", "G", "#", "#", "#", "#", "#", "#", "#", "#", "#", "#", "#", "#", "#", "#", "#"],
    ["#", "G", "G", " ", "#", " ", " ", " ", "#", "#", "#", "#", "#", "#", "#", "#", "#", "#", "#", "#", "#"],
    ["#", "#", "#", " ", "#", "#", "#", " ", "#", "#", "#", "#", "#", "#", "#", "#", "#", "#", "#", "#", "#"],
    ["#", "G", "T", " ", "G", "T", "#", " ", "#", " ", "#", "G", "#", "#", "#", "#", "#", "#", "#", "#", "#"],
    ["#", "#", "#", " ", "#", "#", "#", " ", "#", "G", "#", " ", "#", "#", "#", "#", "#", "#", "#", "#", "#"],
    ["#", "T", " ", " ", " ", "G", "#", " ", " ", " ", " ", " ", "T", " ", "#", "#", "#", "#", "#", "#", "#"],
    ["#", "#", "#", " ", "#", " ", "#", "#", "#", " ", "#", "#", "#", "#", "#", "#", "#", "#", "#", "#", "#"],
    ["#", "T", "#", "G", "#", " ", " ", " ", "#", " ", " ", "T", "#", "#", "#", "#", "#", "#", "#", "#", "#"],
    ["#", "T", "#", "#", "#", "#", "#", " ", "#", "#", "#", " ", "#", "#", "#", "#", "#", "#", "#", "#", "#"],
    ["#", "T", "#", "T", "G", "G", "G", " ", " ", " ", "#", " ", " ", " ", "#", "#", "#", "#", "#", "#", "#"],
    ["#", " ", "#", "#", "#", "#", "#", "#", "#", " ", "#", "#", "#", "G", "#", "#", "#", "#", "#", "#", "#"],
    ["#", " ", " ", " ", " ", " ", "G", " ", " ", " ", "#", "G", "#", " ", " ", " ", "#", " ", " ", " ", "#"],
    ["#", " ", "#", "#", "#", "#", "#", "#", "#", "#", "#", "T", "#", "#", "#", " ", "#", " ", "#", " ", "#"],
    ["#", " ", "#", " ", " ", " ", "#", " ", " ", " ", " ", " ", "G", "G", "#", " ", "#", " ", "#", " ", "#"],
    ["#", " ", "#", " ", "#", " ", "#", " ", "#", "#", "#", " ", "#", "#", "#", " ", "#", " ", "#", "B", "#"],
    ["#", " ", " ", " ", "#", " ", " ", " ", "#", " ", "G", " ", " ", "S", "#", " ", " ", " ", "#", "E", "#"],
    ["#", "#", "#", "#", "#", "#", "#", "#", "#", "#", "#", "#", "#", "#", "#", "#", "#", "#", "#", "#", "#"]
  ],
  "B": [31, 44, 16, 27],
  "PlayerSkills": [[6, 0], [11, 1], [10, 1]],
  "minRouds": 103,
  "CoinConsumption": 250
}
